##B########
#  ##   ###
# ### ##A #
#     ### #
#####     #