##B########
#  ##   ###
# ######A #
#     ### #
#####     #